R 1920 1080
NO ./path_to_the_north_texture
SO ./path_to_the_south_texture
WE ./path_to_the_west_texture
EA 		./path_to_the_east_texture
S                 ./path_to_the_sprite_texture

F 220,100,0


C 225,30,0

11111111111111111111111111111
10000000000000000000000000001
10111101001001001110000000001
10100001010010101010000000001
101N0001100010101110000000001
10100001010010101000000000001
10111101001001001000000000001
10000000000000000000000000001
11111111111111111111111111111