R 1280 720
NO ./tests/maps/textures/wool_colored_light_blue.png
SO ./tests/maps/textures/wool_colored_lime.png
WE ./tests/maps/textures/wool_colored_red.png
EA ./tests/maps/textures/wool_colored_yellow.png
S ./tests/maps/textures/pillar.png
F 220,100,0
C 225,30,0

1111111111
1000000001
1000011001
1000000001
1000010001
1100000001
11000W0011
1100000001
1100000001
1000000001
1000000001
1000000001
1000000001
1111111111