R 1280 720

NO ./textures/grey.png
SO ./textures/mossy.png

WE ./textures/redbrick.png

EA ./textures/wood.png

S ./textures/pillar.png

F 207,140,211

C 100,4,30

111111111111111111
100000000000000011
100000000000000011
100000000N00000011
111111111111111111