
R           1600 		 	  900

NO ./textures/mossy.png
SO ./textures/mossy.png
WE ./textures/redbrick.png
EA ./wtf
S ./textures/pillar.png

F 220,100,0
C 225,30,0

1111111111111111111111111
1000000000110000000000001
1011000001110000002000001
1001000000000000000000001
1111111110110000011100001
1000000000110010011101111
1111011111111111110000001
1111011111111101110101001
1100000011010101110000001
1000N00000000000110000001
1000000000000000110101001
1100000111010101111101111
1111011111110101110111101
1111111111111111111111111
