R 1280 720

NO ./textures/grey.png
SO ./textures/mossy.png

WE ./textures/redbrick.png

EA ./textures/wood.png

S ./textures/pillar.png

F 100,4,30

C 260,100,255

        1111111111111111111111111
        1000000000110000000000001
        1011000001110000002000001
        1001000000000000000000001
111111111011000001110000000000001
100000000011000001110111110111111
11110111111111011100000010001
11110111111111011101010010001
11000000110101011100000010001   
100020000000000011000N0010001
10000000000000001111010010001
1100000111010101    111011111
11110111 1110101 1111010001
11111111 1111111 111111111111